wwwwwwwwwwwwwwwwwwwwwwwwwwwwwwww
w..............................w
w..............................w
w..............................w
w..............................w
w..............................w
w..............................w
w..............................w
w...........p...........e......w
w..............................w
w..............................w
w..............................w
w...........e..................w
w..............................w
w..............................w
w..............................w
w..............................w
w..............................w
w..............................w
w..............................w
w..............................w
w..............................w
w..............................w
wwwwwwwwwwwwwwwwwwwwwwwwwwwwwwww